11111111
1P000CE1
10000001
10000001
11111111
