11111111
1000C0E1
10000001
100P0001
11111111
