1111111111
1PC0100001
1001111111
1E00C000C1
1111111111