11111111
100C00E1
1000C001
1C0P0001
11111111
