1111111111111111111111111111111111
1E000000000000GC00000C00000G000001
1010010100100000101001000000G10101
1010010010101010001001000000G10101
1P0000000C00CG00000000000000G00GC1
100000000000000C00000C0000G0000G01
1010010100100000101001000000010101
101001001010101000100100000G0101G1
100000000C00C0000G0000000000000GC1
100000000G00000C00000C00000G0000G1
1010010100100000101001000000010101
1010010010101010001001000000010101
100000000C00C0000000000000000000C1
100000000C00C0000000000000G0000GC1
1000000000G0000C0000GC0000000G0001
101001010010000010100100000G010101
1111111111111111111111111111111111
