1111111111111111111111111111111111
1E0000000000000C00000C000000000001
1010010100100000101001000000010101
1010010010101010001001000000010101
1P0000000C00CG00000000000000G000C1
100000000000000C00000C0000G0000001
1010010100100000101001000000010101
101001001010101000100100000G010101
100000000C00C0000G00000000000000C1
100000000G00000C00000C00000G000001
1010010100100000101001000000010101
1010010010101010001001000000010101
100000000C00C0000000000000000000C1
100000000C00C0000000000000G00000C1
1000000000G0000C00000C000000000001
1010010100100000101001000000010101
1111111111111111111111111111111111